1 3 1 1 1 1 1 1 1 1 1 1 1 1 1 1 1 1 1 1 1 1 1 1 1 1 1 1 1 1 1 1 1 1 1 1 1 1 1 1 1 1 1 1 1 1 1 1 1 1 1 1 1 1 1 1 1 1 1 
1 5 1 5 5 5 5 5 1 5 5 5 1 2 2 2 2 5 5 5 5 5 5 5 1 2 1 2 2 2 2 2 2 2 1 2 2 2 1 2 2 5 5 5 5 5 5 5 1 2 2 2 2 2 1 2 2 2 1 
1 5 1 5 1 1 1 5 1 5 1 5 1 1 1 1 1 5 1 1 1 1 1 5 1 2 1 2 1 1 1 1 1 2 1 2 1 2 1 2 1 5 1 1 1 1 1 5 1 2 1 1 1 2 1 2 1 2 1 
1 5 5 5 1 2 1 5 1 5 1 5 1 5 5 5 1 5 5 5 5 5 1 5 1 2 2 2 1 2 2 2 2 2 1 2 1 2 1 2 1 5 5 5 1 2 1 5 1 2 2 2 1 2 1 2 1 2 1 
1 1 1 1 1 2 1 5 1 5 1 5 1 5 1 5 1 2 1 1 1 5 1 5 1 1 1 1 1 2 1 1 1 1 1 2 1 2 1 2 1 1 1 5 1 2 1 5 1 2 1 2 1 2 1 1 1 2 1 
1 2 1 5 5 5 1 5 1 5 1 5 5 5 1 5 1 2 1 2 1 5 1 5 5 5 5 5 1 2 1 2 2 2 1 2 1 2 1 2 1 5 5 5 1 2 1 5 1 2 1 2 1 2 2 2 1 2 1 
1 2 1 5 1 5 1 5 1 5 1 1 1 1 1 5 1 2 1 2 1 5 1 1 1 1 1 5 1 2 1 2 1 2 1 2 1 2 1 2 1 5 1 1 1 2 1 5 1 1 1 2 1 1 1 2 1 2 1 
1 2 1 5 1 5 5 5 1 5 1 2 1 5 5 5 1 2 1 2 1 5 1 2 2 5 5 5 1 2 2 2 1 2 2 2 1 2 2 2 1 5 5 5 1 2 1 5 5 5 1 2 2 2 1 2 1 2 1 
1 2 1 5 1 1 1 1 1 5 1 2 1 5 1 1 1 2 1 2 1 5 1 1 1 5 1 1 1 2 1 1 1 1 1 1 1 1 1 2 1 1 1 5 1 2 1 1 1 5 1 2 1 2 1 2 1 2 1 
1 2 1 5 1 5 5 5 1 5 1 2 1 5 5 5 1 2 1 2 1 5 5 5 1 5 1 2 2 2 1 5 5 5 1 5 5 5 1 2 1 5 5 5 1 5 5 5 5 5 1 2 1 2 1 2 2 2 1 
1 2 1 5 1 5 1 5 1 5 1 2 1 1 1 5 1 2 1 2 1 1 1 5 1 5 1 1 1 1 1 5 1 5 1 5 1 5 1 1 1 5 1 1 1 5 1 1 1 1 1 2 1 2 1 1 1 2 1 
1 5 5 5 1 5 1 5 1 5 1 5 5 5 1 5 1 2 1 2 2 2 1 5 1 5 1 5 5 5 5 5 1 5 5 5 1 5 5 5 5 5 1 2 1 5 1 2 2 2 2 2 1 2 2 2 1 2 1 
1 5 1 1 1 5 1 5 1 5 1 5 1 5 1 5 1 2 1 2 1 1 1 5 1 5 1 5 1 1 1 1 1 1 1 1 1 1 1 1 1 1 1 2 1 5 1 1 1 1 1 1 1 1 1 2 1 1 1 
1 5 5 5 1 5 1 5 1 5 1 5 1 5 5 5 1 2 2 2 1 5 5 5 1 5 1 5 1 5 5 5 1 5 5 5 2 2 1 5 5 5 2 2 1 5 1 5 5 5 5 5 5 5 1 2 2 2 1 
1 1 1 5 1 5 1 5 1 5 1 5 1 1 1 1 1 2 1 1 1 5 1 1 1 5 1 5 1 1 1 5 1 5 1 5 1 1 1 5 1 5 1 2 1 5 1 5 1 1 1 1 1 5 1 2 1 2 1 
1 5 5 5 1 5 1 5 1 5 1 5 1 2 2 2 2 2 1 5 5 5 1 5 5 5 1 5 5 5 1 5 1 5 1 5 1 5 5 5 1 5 1 2 1 5 1 5 1 2 2 5 5 5 1 2 1 2 1 
1 5 1 1 1 5 1 5 1 5 1 5 1 2 1 1 1 1 1 5 1 1 1 5 1 1 1 1 1 5 1 5 1 5 1 5 1 5 1 1 1 5 1 2 1 5 1 5 1 1 1 5 1 1 1 2 1 2 1 
1 5 5 5 1 5 1 5 5 5 1 5 1 2 1 5 5 5 5 5 1 2 1 5 1 2 2 5 5 5 1 5 5 5 1 5 5 5 1 2 1 5 1 2 1 5 1 5 5 5 1 5 5 5 1 2 1 2 1 
1 1 1 5 1 5 1 1 1 1 1 5 1 1 1 5 1 1 1 1 1 2 1 5 1 2 1 5 1 2 1 1 1 1 1 2 1 1 1 2 1 5 1 1 1 5 1 1 1 5 1 1 1 5 1 1 1 2 1 
1 2 1 5 1 5 5 5 5 5 1 5 5 5 5 5 1 2 1 5 5 5 5 5 1 2 1 5 1 2 1 5 5 5 1 2 2 2 2 2 1 5 5 5 1 5 5 5 1 5 5 5 1 5 5 5 5 5 1 
1 2 1 5 1 2 1 1 1 5 1 1 1 1 1 1 1 2 1 5 1 1 1 1 1 1 1 5 1 2 1 5 1 5 1 2 1 1 1 1 1 1 1 5 1 1 1 5 1 1 1 5 1 1 1 1 1 5 1 
1 2 1 5 1 2 2 2 1 5 5 5 1 2 2 2 2 2 1 5 5 5 1 2 2 5 5 5 1 2 1 5 1 5 1 2 1 5 5 5 5 5 1 5 2 2 1 5 5 5 1 5 5 5 1 5 5 5 1 
1 2 1 5 1 1 1 2 1 1 1 5 1 2 1 1 1 2 1 1 1 5 1 1 1 5 1 1 1 1 1 5 1 5 1 2 1 5 1 1 1 5 1 5 1 1 1 1 1 5 1 2 1 5 1 5 1 1 1 
1 5 5 5 1 2 2 2 1 5 5 5 1 2 2 2 1 2 2 2 1 5 1 5 5 5 1 5 5 5 5 5 1 5 1 2 1 5 1 2 2 5 5 5 1 5 5 5 1 5 1 2 1 5 1 5 5 5 1 
1 5 1 1 1 1 1 1 1 5 1 1 1 2 1 2 1 1 1 1 1 5 1 5 1 1 1 5 1 1 1 1 1 5 1 1 1 5 1 2 1 1 1 1 1 5 1 5 1 5 1 2 1 5 1 1 1 5 1 
1 5 1 2 2 5 5 5 1 5 1 2 2 2 1 2 1 5 5 5 1 5 1 5 1 5 5 5 1 2 2 2 1 5 5 5 1 5 1 2 1 5 5 5 1 5 1 5 5 5 1 2 1 5 1 2 1 5 1 
1 5 1 1 1 5 1 5 1 5 1 2 1 1 1 2 1 5 1 5 1 5 1 5 1 5 1 1 1 1 1 2 1 1 1 5 1 5 1 2 1 5 1 5 1 5 1 1 1 1 1 1 1 5 1 2 1 5 1 
1 5 1 5 5 5 1 5 5 5 1 2 1 2 1 2 1 5 1 5 5 5 1 5 1 5 5 5 1 2 2 2 1 5 5 5 1 5 1 2 1 5 1 5 5 5 1 5 5 5 5 5 5 5 1 2 1 5 1 
1 5 1 5 1 1 1 1 1 1 1 2 1 2 1 2 1 5 1 1 1 1 1 5 1 1 1 5 1 2 1 2 1 5 1 1 1 5 1 1 1 5 1 1 1 1 1 5 1 1 1 1 1 1 1 2 1 5 1 
1 5 5 5 1 2 2 2 1 2 2 2 1 2 1 2 1 5 5 5 1 2 2 5 5 5 5 5 2 2 1 2 1 5 1 2 2 5 1 5 5 5 1 5 5 5 5 5 1 2 2 2 2 2 2 2 1 5 1 
1 1 1 1 1 2 1 2 1 2 1 1 1 2 1 2 1 1 1 5 1 1 1 1 1 1 1 1 1 1 1 1 1 5 1 2 1 5 1 5 1 1 1 5 1 1 1 1 1 2 1 1 1 1 1 1 1 5 1 
1 2 2 2 2 2 1 2 2 2 2 2 2 2 1 2 2 2 2 5 5 5 5 5 5 5 5 5 5 5 5 5 5 5 1 2 1 5 5 5 5 5 5 5 1 2 2 2 2 2 2 2 2 2 2 2 2 5 1 
1 1 1 1 1 1 1 1 1 1 1 1 1 1 1 1 1 1 1 1 1 1 1 1 1 1 1 1 1 1 1 1 1 1 1 1 1 1 1 1 1 1 1 1 1 1 1 1 1 1 1 1 1 1 1 1 1 4 1 
---
length=640
time=2895